border_size=1
usage=map

Gs^Fp       , Gs^Fp       , Gs^Fds      , Gs^Fp       , Gs^Fms      , Hh^Fp       , Hh          , Hh^Fp       , Hh          , Hh          , Hh          , Hh          , Hh          , Hh          , Hh          , Hh          , Gg          , Ww          , Ww          , Ww          , Gg          , Gg          , Gg          , Gg          , Gg          , Gg          , Gg          , Gg          , Gg          , Gs^Fdf      , Gs^Fdf      , Gs^Fdf      , Gs^Fmf      , Gs^Fdf      , Gs^Fdf      , Gs^Fdf      
Gs^Fp       , Gs^Fp       , Gs^Fms      , Gs^Fms      , Gs^Fp       , Gs^Fp       , Hh^Fds      , Hh          , Hh          , Hh^Fms      , Hh          , Hh^Fp       , Hh          , Hh          , Hh^Fds      , Gg          , Ww          , Ww          , Gg          , Ggf         , Gg          , Gg          , Gg^Vh       , Gg          , Gg          , Gg          , Gg          , Gg          , Gs^Fdf      , Gs^Fmf      , Gs^Fdf      , Gs^Fdf      , Gs^Fdf      , Gs^Fdf      , Gs^Fmf      , Gs^Fdf      
Gs^Fp       , Gs^Fms      , Gs^Fds      , Gs^Fp       , Hh^Fp       , Gs^Fms      , Hh          , Hh^Fp       , Hh^Fds      , Hh^Fp       , Hh^Fms      , Hh          , Hh          , Hh          , Hh          , Hh          , Ww          , Ww          , Gg          , Gg          , Gg          , Gg          , Gg          , Gg          , Cud         , Cud         , 6 Kud       , Gg          , Gg          , Gg          , Gg          , Gs^Fmf      , Gg          , Gg          , Gs^Fdf      , Gg          
Gs^Fms      , Gs^Fp       , Re^Gvs      , Gs^Fms      , Hh          , Hh^Fp       , Hh^Fp       , Hh^Fms      , Gs^Fms      , Hh          , Hh          , Hh^Fms      , Hh          , Hh          , Hh^Vhh      , Gg          , Gg          , Ww^Bw/      , Ww          , Hh          , Mm          , Gg          , Gg          , Gg          , Cud         , Gg          , Cud         , Gg          , Gg          , Gg          , Gg          , Gs^Fdf      , Gg          , Gg          , Gg          , Gg          
Gs^Fms      , Gs^Fms      , Re^Gvs      , Re^Gvs      , Re^Gvs      , Gg^Vh       , Hh^Fp       , Gs^Fms      , Gg          , Hh^Fds      , Hh          , Re^Gvs      , Re^Gvs      , Re^Gvs      , Re^Gvs      , Re^Gvs      , Gg          , Ww          , Ww          , Ww          , Hh          , Hh^Fmw      , Gg          , Gg          , Gg          , Cud         , Gg          , Gg          , Gg          , Gg          , Rd          , Rd          , Rd          , Rd          , Rd          , Rd          
Gs^Fms      , Gs^Fms      , Gs^Fds      , Gg          , Re^Gvs      , Re^Gvs      , Gs^Fms      , Gs^Fms      , Gg          , Gg          , Gg          , Re^Gvs      , Re^Gvs      , Chr         , Chr         , Re^Gvs      , Re^Gvs      , Ggf         , Ww          , Ww          , Hh          , Gg          , Hh          , Gg          , Gg          , Gg          , Ggf         , Gg          , Gg          , Rd          , Gg          , Gg          , Gg          , Gg          , Gg          , Gg          
Gs^Fms      , Gs^Fp       , Gs^Fms      , Gg          , Gs^Fds      , Gs^Fms      , Gs^Fds      , Gs^Fms      , Gs^Fms      , Gg          , Gg          , Re^Gvs      , Re^Gvs      , 4 Khr       , Chr         , Re^Gvs      , Re^Gvs      , Ww          , Ww          , Mm          , Mm          , Mm          , Hh          , Gg          , Gg          , Gg          , Gg          , Gg          , Gg          , Rd          , Rd          , Gg          , Re^Gvs      , Gg^Ve       , Re^Gvs      , Gg          
Gg          , Gg          , Gg          , Gg          , Gg          , Gs^Fms      , Gs^Fms      , Gs^Fp       , Gg          , Gg          , Gg          , Gg          , Gg          , Re^Gvs      , Gg          , Re^Gvs      , Ww          , Ww          , Mm          , Mm          , Hh          , Mm^Vhh      , Hh          , Hh          , Gg          , Gg          , Rd          , Gg          , Rd          , Gg          , Rd          , Gg          , Re^Gvs      , Re^Gvs      , Re^Gvs      , Re^Gvs      
Gs^Fms      , Gg          , Gg^Ve       , Gg          , Gg          , Gs^Fp       , Gg          , Gg          , Gg          , Hh^Fdw      , Hh          , Hh          , Gg          , Gg          , Hh          , Gg          , Ww          , Ww          , Mm          , Hh          , Gg          , Gg          , Gg          , Hh^Fdw      , Gg          , Rd          , Gg          , Rd          , Gg^Ve       , Rd          , Gg          , Gg          , Gs^Fp       , Re^Gvs      , Gg          , Re^Gvs      
Gg          , Gg          , Gg          , Gg          , Gs^Fds      , Gg          , Gg          , Gg          , Gg          , Gg          , Gg          , Mm          , Hh          , Hh          , Mm          , Gg          , Ww          , Ww          , Hh          , Hh          , Rd          , Gg          , Rd          , Gg          , Rd          , Rd          , Gg          , Gs^Fp       , Gg          , Gg          , Gs^Fms      , Gg          , Gs^Fmw      , Gg          , Gs^Fp       , Gg          
Gg          , Gs^Fms      , Gg          , Gg          , Gs^Fms      , Gs^Fms      , Gg          , Gg          , Gg          , Gg          , Gg          , Hh          , Hh^Fdw      , Mm          , Ww          , Ww          , Ww          , Hh^Fdw      , Rd          , Rd          , Gg          , Rd          , Hh^Fdw      , Rd          , Hh^Fmw      , Hh^Fp       , Hh^Fp       , Gs^Fp       , Gs^Fmw      , Gs^Fp       , Ss          , Gs^Fp       , Gs^Fp       , Gs^Fp       , Gs^Fmw      , Gg          
Rd          , Gg          , Rd          , Gg          , Rd          , Rd          , Rd          , Rd          , Rd          , Gg^Ve       , Rd          , Gg          , Ww          , Ww          , Ww          , Ww^Vm       , Gg          , Gg          , Rd          , Gg          , Hh          , Hh          , Hh          , Hh          , Hh^Fp       , Hh^Fp       , Gs^Fmw      , Re^Gvs      , Gs^Fmw      , Gs^Fp       , Gs^Fmw      , Gs^Fp       , Gs^Fmw      , Ss          , Gg          , Gg          
Gg          , Rd          , Gg          , Rd          , Gg          , Gg          , Ch          , Re^Gvs      , Re^Gvs      , Rd          , Gg          , Rd          , Ww^Bw\      , Ww          , Gg          , Gg          , Gg          , Ggf         , Rd          , Gg          , Hh^Fp       , Hh          , Re^Gvs      , Re^Gvs      , Re^Gvs      , Re^Gvs      , Re^Gvs      , Re^Gvs      , Ss          , Gs^Fp       , Ss^Vhs      , Gg          , Gg          , Gs^Fp       , Gs^Fmf      , Gg          
Gs^Fp       , Gg          , Gs^Fp       , Gg          , Gs^Fms      , Ch          , Re^Gvs      , Re^Gvs      , Re^Gvs      , Re^Gvs      , Re^Gvs      , Ww          , Ww          , Rd          , Rd          , Gg          , Gg          , Gg          , Rd          , Gg          , Gg          , Hh          , Re^Gvs      , Re^Gvs      , Chr         , 5 Khr       , Chr         , Re^Gvs      , Gs^Fp       , Gs^Fmf      , Gs^Fp       , Gs^Fp       , Gg          , Gs^Fp       , Gs^Fp       , Gs^Fp       
Gs^Fp       , Gs^Fms      , Gs^Fms      , Gs^Fms      , 2 Kh        , Ch          , Re^Gvs      , Re^Gvs      , Re^Gvs      , Re^Gvs      , Ww          , Ww          , Ww          , Gg          , Gg          , Rd          , Rd          , Rd          , Gg          , Gg^Ve       , Gg          , Gg          , Gg          , Re^Gvs      , Re^Gvs      , Chr         , Re^Gvs      , Re^Gvs      , Re^Gvs      , Gg          , Gg          , Gg          , Gg          , Gs^Fp       , Gs^Fmw      , Gs^Fp       
Gs^Fms      , Gs^Fds      , Gg          , Gs^Fms      , Ch          , Re^Gvs      , Re^Gvs      , Re^Gvs      , Re^Gvs      , Ww          , Ww          , Ww          , Gs^Fds      , Gs^Fds      , Gg          , Rd          , Rd          , Gg          , Rd          , Gg          , Rd          , Rd          , Rd          , Gg          , Gg          , Gg          , Gs^Fp       , Gs^Fp       , Gs^Fp       , Gs^Fmw      , Gs^Fp       , Gg          , Gs^Fmw      , Gs^Fp       , Gs^Fmw      , Gg          
Gg          , Gs^Fms      , Gg          , Ch          , Re^Gvs      , Re^Gvs      , Re^Gvs      , Re^Gvs      , Ww          , Ww          , Gs^Fds      , Gs^Fds      , Gs^Fds      , Gg^Ve       , Rd          , Rd          , Gg          , Rd          , Gg          , Rd          , Gg          , Gg          , Gg          , Rd          , Gg          , Ggf         , Gg          , Gs^Fp       , Gg          , Gs^Fp       , Gs^Fmw      , Gs^Fp       , Gs^Fp       , Ss          , Gs^Fp       , Gg          
Gs^Fms      , Gg          , Gg          , Ch          , Gg          , Gg          , Gg^Vh       , Ww          , Ww          , Ww          , Gs^Fds      , Gs^Fds      , Gs^Fds      , Rd          , Gg          , Gg          , Gg          , Ggf         , Gg          , Gg          , Hh          , Gg          , Gg          , Rd          , Rd          , Rd          , Rd          , Gs^Fmw      , Rd          , Rd          , Rd          , Gs^Fp       , Gg          , Gs^Fmw      , Gg          , Gg          
Gs^Fms      , Gs^Fp       , Gg          , Gg          , Ww          , Gg          , Ww          , Ww          , Ww          , Gs^Fds      , Gs^Fds      , Gg          , Rd          , Rd          , Gg          , Hh          , Gg          , Gg          , Gg          , Hh          , Hh          , Hh^Fdw      , Hh          , Gg          , Gg          , Gg          , Gg          , Rd          , Gg          , Gg          , Rd          , Gg          , Gg          , Gs^Fp       , Ggf         , Gg          
Gg          , Gg          , Ggf         , Ww          , Ww          , Ww^Bw|      , Ww          , Ww          , Gs^Fds      , Gs^Fds      , Gs^Fds      , Gg          , Rd          , Gg          , Gg          , Hh          , Hh^Fp       , Hh          , Hh          , Hh          , Mm          , Hh          , Hh          , Gg          , Gg          , Gg          , Hh          , Gg          , Hh          , Gg          , Gg^Vh       , Rd          , Gg          , Gg          , Gg          , Gg          
Gg          , Gg          , Ww          , Ww          , Re^Gvs      , Re^Gvs      , Re^Gvs      , Gs^Fds      , Re^Gvs      , Gs^Fds      , Gg          , Rd          , Gg          , Gg          , Hh          , Hh          , Mm          , Hh          , Hh^Vc       , Hh          , Hh          , Hh          , Gg          , Gg          , Gg          , Hh          , Mm^Vc       , Mm          , Hh          , Gg          , Gg          , Rd          , Rd          , Rd          , Rd          , Gg          
Gg          , Gg          , Ww          , Ww          , Re^Gvs      , Re^Gvs      , Chr         , Re^Gvs      , Re^Gvs      , Gg          , Rd          , Rd          , Gg          , Gg          , Gg          , Hh          , Hh          , Hh          , Hh          , Hh          , Hh          , Gg          , Gg          , Gg          , Gg          , Hh          , Gg          , Hh          , Gg          , Gg          , Gg          , Gg          , Gg          , Gg          , Gg          , Rd          
Ww          , Ww          , Ww          , Re^Gvs      , Re^Gvs      , 3 Khr       , Chr         , Re^Gvs      , Gg          , Gg^Ve       , Rd          , Gg          , Ggf         , Gg          , Hh          , Hh          , Hh^Fp       , Hh          , Hh^Fp       , Gg          , Gg          , Gg          , Gg          , Ggf         , Gg          , Gg          , Gg          , Gg          , Re^Gvs      , Re^Gvs      , Re^Gvs      , Gs^Fp       , Gg          , Ggf         , Gg          , Gg          
Ww          , Ww          , Hh          , Re^Gvs      , Re^Gvs      , Re^Gvs      , Re^Gvs      , Gg          , Gg          , Rd          , Gg          , Gg          , Gg          , Gg          , Hh^Fp       , Hh^Fms      , Hh^Fp       , Hh          , Hh          , Gg          , Gg          , Gg          , Gg          , Gg          , Ce          , Gg          , Gg          , Gg          , Gg          , Re^Gvs      , Re^Gvs      , Gs^Fp       , Gs^Fms      , Gs^Fp       , Gg          , Gg          
Mm          , Ww          , Hh          , Hh^Fdw      , Gg          , Gg          , Gg          , Gg          , Rd          , Rd          , Gg          , Hh          , Hh          , Hh          , Hh^Fp       , Hh          , Hh^Fp       , Hh^Fp       , Hh^Fp       , Hh          , Gg          , Gg          , Ce          , Ce          , 1 Ke        , Ce          , Ce          , Gg          , Gg          , Re^Gvs      , Gs^Fp       , Re^Gvs      , Gs^Fp       , Gs^Fp       , Gs^Fp       , Gg          
Mm          , Hh          , Hh          , Gg          , Gg          , Ggf         , Gg          , Rd          , Gg          , Gg          , Hh          , Hh          , Hh^Fp       , Hh^Fp       , Gs^Fp       , Gs^Fp       , Gs^Fms      , Gs^Fp       , Hh          , Hh          , Gg          , Gg          , Gg          , Ce          , Ce          , Ce          , Gg          , Gg          , Gg          , Gg          , Gg          , Gs^Fp       , Gs^Fp       , Gs^Fms      , Gs^Fp       , Gg          
Mm          , Mm          , Hh          , Hh          , Hh          , Gg          , Rd          , Rd          , Gg          , Gg          , Gg          , Gg          , Hh          , Hh          , Hh^Fp       , Gs^Fp       , Gg          , Gg          , Gg          , Gg          , Gg          , Gg          , Gg          , Gg          , Gg          , Gg          , Gg          , Ggf         , Gg          , Gg          , Gg          , Gs^Fms      , Gs^Fp       , Gs^Fp       , Gs^Fp       , Gs^Fms      
Mm          , Mm          , Mm          , Hh          , Hh          , Gg          , Rd          , Gg          , Gg          , Gg          , Gg          , Hh          , Hh          , Hh^Fp       , Gs^Fp       , Gs^Fms      , Gs^Fp       , Gg          , Gg          , Gg          , Gg          , Gg          , Gg          , Gg          , Gg          , Gg          , Gg          , Gg          , Gg          , Gs^Fp       , Gs^Fp       , Gs^Fp       , Gs^Fms      , Gs^Fp       , Gs^Fms      , Gs^Fp       
