border_size=1
usage=map

Mm          , Hh          , Mm          , Mm          , Mm          , Hh          , Hh^Fdw      , Mm          , Gg          , Gg          , Gg          , Gg          , Gg          , Gg          , Ww          , Gg          , Gg          , Gg          , Gs^Fp       , Gs^Fp       , Gs^Fms      , Gs^Fp       , Gs^Fp       , Gs^Fp       , Gs^Fp       , Gs^Fms      , Gg          , Gg          , Gg          , Gg          
Mm          , Mm          , Mm          , Hh          , Hh          , Gg          , Gg          , Gg          , Ch          , Gg          , Gg          , Gg          , Gg          , Ww          , Gg          , Gg          , Gg          , Gs^Fms      , Gg          , Gs^Fp       , Gg          , Gs^Fp       , Gg          , Gs^Fms      , Gg          , Gs^Fp       , 5 Ke        , Gg          , Gg          , Gg          
Mm          , Mm          , Hh          , Gg          , Gg          , Gg          , Gg          , 2 Kh        , Ch          , Gg          , Gg          , Gg          , Ww          , Ww          , Gg^Vh       , Gg          , Gg          , Gg          , Gg          , Gg          , Gg          , Gs^Fp       , Gg          , Gg          , Gg          , Ce          , Ce          , Ce          , Gg          , Gg          
Ww          , Mm          , Ww          , Hh^Fdw      , Ww          , Gg          , Gg          , Gg          , Gg          , Gg          , Ww          , Gg          , Ww^Bw\      , Gg          , Gg          , Gg          , Gg          , Gg          , Gg          , Gg          , Gg          , Gg          , Gg          , Gg          , Gg          , Gg          , Gg          , Gg          , Gs^Fp       , Gg          
Ww          , Ww          , Ww          , Ww          , Ww          , Ww          , Ww          , Gg^Vh       , Ww          , Ww          , Gg          , Ww          , Gg          , Gg          , Gg          , Gg          , Hh          , Gg          , Gg          , Hh^Fdw      , Gg          , Gg          , Gg          , Gg          , Gg^Ve       , Gg          , Gs^Fp       , Gg          , Gs^Fms      , Gg          
Ww          , Ww          , Ww          , Ww          , Ww          , Ww          , Ww          , Ww          , Gg          , Gg          , Ggf         , Gg          , Gg          , Gg          , Gg          , Gg          , Hh          , Mm          , Mm          , Hh^Vc       , Gg          , Gg          , Ggf         , Gg          , Gg          , Gg          , Gs^Fms      , Gs^Fp       , Gs^Fms      , Gs^Fp       
Ww          , Ww          , Ww          , Ww^Vm       , Ww          , Ww          , Ww          , Ww          , Gg^Ve       , Gg          , Gg          , Gg          , Gg          , Gg          , Hh          , Hh          , Mm          , Hh          , Hh          , Gg          , Gg          , Gg          , Gg          , Gg          , Gg          , Gg          , Gg          , Gg          , Gs^Fp       , Gs^Fms      
Ww          , Ww          , Ww          , Ww          , Ww          , Ww          , Ww          , Ww          , Ww^Bw/      , Gg          , Gg          , Gg          , Hh          , Gg          , Hh          , Mm          , Hh          , Gg          , Gg          , Hh          , Gg          , Gg          , Gg          , Gg          , Gg          , Gg          , Gg          , Gs^Fms      , Gs^Fp       , Gs^Fp       
Ww          , Ww          , Ww          , Ww          , Cud         , Ch          , Ch          , Ww^Bw/      , Ww          , Gg          , Gg          , Gg          , Gg          , Hh          , Mm          , Mm^Vhh      , Hh          , Gg          , Gg          , Gg          , Gg          , Gg          , Gg          , Chr         , Gg          , Gg          , Gg          , Gg          , Gs^Fp       , Gs^Fms      
Ww          , Ww          , Ww          , Cud         , 4 Gg        , Cud         , Ch          , Ww          , Ww^Vm       , Ww          , Gg          , Gg          , Gg          , Gg          , Hh          , Mm          , Hh          , Gg          , Gg          , Gg          , Gg          , Gg          , Chr         , Chr         , 1 Khr       , Chr         , Chr         , Gg          , Gg          , Gs^Fms      
Ww          , Ww          , Ww          , Cud         , Cud         , Cud         , Ch          , Ww          , Ww          , Ww          , Gg          , Gg          , Gg          , Hh          , Hh^Fdw      , Gg          , Gg          , Gg          , Gg          , Gg          , Gg          , Gg          , Chr         , Gg          , Chr         , Gg          , Gg          , Gg          , Gg          , Gs^Fp       
Ww          , Ww          , Ww          , Ww          , Ww          , Ch          , Ww          , Ww^Bw\      , Ww^Bw\      , Ww          , Gg          , Gg          , Gg^Vh       , Gg          , Gg          , Gg          , Gg          , Gg          , Gg          , Gg          , Gg          , Gg          , Gg          , Chr         , Gg          , Chr         , Gg          , Gg          , Gs^Fms      , Gs^Fp       
Ww          , Ww          , Ww          , Ww          , Ww          , Ww          , Ww          , Ww          , Ww          , Gg          , Gg          , Gg          , Gg          , Gg          , Ggf         , Gg          , Gg          , Gg          , Gg^Ve       , Ggf         , Gg          , Gg          , Gg          , Chr         , Chr         , Chr         , Gg          , Gg          , Gg          , Gg          
Ww          , Ww          , Ww^Vm       , Ww          , Ww          , Ww          , Ww          , Ww          , Ww          , Gs^Fp       , Gs^Fp       , Gg          , Gg          , Gg          , Gg          , Gg          , Hh          , Gg          , Gg          , Gg          , Gg          , Gg          , Gg          , Chr         , Gg          , Gg          , Gg          , Gg          , Gg          , Gg          
Ww          , Ww          , Ww          , Ww          , Ww          , Gs^Fp       , Gs^Fms      , Hh^Fp       , Gs^Fp       , Ww          , Gg          , Gg          , Gg          , Gg          , Hh^Fms      , Gg          , Hh          , Hh          , Hh          , Gg          , Hh          , Gg          , Gg          , Gg          , Gg          , Gg          , Gg          , Ggf         , Gg          , Gg          
Gs^Fp       , Ww          , Gs^Fp       , Ww          , Hh^Fms      , Hh^Fp       , Hh          , Gg          , Gg          , Ww          , Ww^Bw/      , Gg          , Ww          , Hh          , Hh          , Hh^Vc       , Hh^Fp       , Hh^Fms      , Hh          , Hh^Fp       , Hh          , Gg          , Gg          , Gg          , Gg          , Gg          , Hh          , Gg          , Gg^Ve       , Gg          
Hh^Fp       , Gs^Fms      , Hh^Fp       , Gs^Fp       , Hh^Fp       , Gg          , 3 Kh        , Ch          , Gg          , Gg          , Gg          , Ww          , Gg          , Ww          , Gs^Fp       , Hh          , Hh          , Gs^Fp       , Hh^Fms      , Hh          , Hh^Fp       , Hh^Vhh      , Gg          , Gg          , Hh          , Hh          , Hh^Fp       , Gg          , Hh          , Gg          
Hh          , Hh^Fms      , Hh^Fp       , Hh^Vc       , Gg          , Gg          , Gg          , Ch          , Gg          , Gg          , Gg          , Gg^Ve       , Gg          , Ww          , Gs^Fms      , Gs^Fms      , Hh^Fp       , Hh^Fp       , Hh^Fp       , Hh          , Hh          , Hh^Fms      , Hh          , Gg          , Hh^Fp       , Hh          , Hh^Fms      , Hh          , Hh          , Hh          
Hh          , Hh^Fp       , Gs^Fms      , Hh^Fp       , Hh^Fp       , Gg          , Hh          , Gg          , Gg          , Gg          , Gg          , Gg          , Gg          , Ww          , Ww          , Gs^Fp       , Gs^Fms      , Gs^Fp       , Hh^Fp       , Hh^Fp       , Hh^Fds      , Hh          , Hh^Fms      , Hh          , Gs^Fp       , Hh          , Gs^Fp       , Hh^Fp       , Hh^Fms      , Hh^Fp       
Hh          , Hh^Fp       , Hh          , Hh^Fp       , Hh          , Hh^Fp       , Hh          , Gg          , Gg          , Gg          , Gg          , Gg          , Gg          , Gg          , Gg          , Ww          , Hh          , Gs^Fp       , Hh          , Gs^Fp       , Hh^Fp       , Gs^Fp       , Hh          , Hh^Fp       , Hh^Fds      , Hh^Fp       , Hh^Fds      , Hh^Fp       , Hh          , Hh          
